"","season","offense_completion_percentage","defense_completion_percentage","points_scored","points_allowed","score_differential"
"1",1999,47.7462437395659,0.557251908396947,245,382,-137
"2",1999,50.3663003663004,0.541082164328657,285,380,-95
"3",1999,45.2079566003617,0.494915254237288,324,277,47
"4",1999,54.0489642184558,0.49721706864564,320,229,91
"5",1999,55.1612903225806,0.549319727891157,421,381,40
"6",1999,56.1181434599156,0.571895424836601,272,341,-69
"7",1999,49.8310810810811,0.560578661844485,283,460,-177
"8",1999,48.9010989010989,0.598901098901099,217,437,-220
"9",1999,55.984555984556,0.512237762237762,352,276,76
"10",1999,54.5927209705373,0.526522593320236,314,318,-4
"11",1999,52.520325203252,0.570967741935484,322,323,-1
"12",1999,53.870458135861,0.536412078152753,357,341,16
"13",1999,60.1083032490975,0.541806020066889,423,333,90
"14",1999,56.140350877193,0.501754385964912,396,217,179
"15",1999,56.3218390804598,0.51227495908347,390,322,68
"16",1999,61.2204724409449,0.497504159733777,526,242,284
"17",1999,52.6570048309179,0.539655172413793,269,316,-47
"18",1999,53.8053097345133,0.518324607329843,390,329,61
"19",1999,52.4350649350649,0.495126705653022,326,336,-10
"20",1999,55.9352517985612,0.576323987538941,399,335,64
"21",1999,51.1824324324324,0.523297491039427,299,284,15
"22",1999,48.2112436115843,0.544090056285178,260,434,-174
"23",1999,54.6875,0.540037243947859,299,358,-59
"24",1999,52.8599605522682,0.537162162162162,308,309,-1
"25",1999,45.0676982591876,0.535773710482529,272,357,-85
"26",1999,52.4647887323943,0.492929292929293,317,320,-3
"27",1999,51.3513513513513,0.516393442622951,338,298,40
"28",1999,54.5918367346939,0.580110497237569,295,453,-158
"29",1999,54.8453608247423,0.496688741721854,270,235,35
"30",1999,55.045871559633,0.504950495049505,392,324,68
"31",1999,56.9148936170213,0.523424878836834,443,377,66
"32",2000,53.516295025729,0.616842105263158,210,443,-233
"33",2000,49.2982456140351,0.55637707948244,252,413,-161
"34",2000,52.2058823529412,0.526978417266187,333,165,168
"35",2000,52.5846702317291,0.54251012145749,315,350,-35
"36",2000,53.525641025641,0.604852686308492,310,310,0
"37",2000,52.8998242530756,0.584805653710247,216,355,-139
"38",2000,41.2825651302605,0.5625,185,359,-174
"39",2000,53.57833655706,0.497120921305182,161,419,-258
"40",2000,52.4109014675053,0.577731092436975,294,361,-67
"41",2000,58.6148648648649,0.500821018062397,485,369,116
"42",2000,50.3676470588235,0.541592920353982,307,307,0
"43",2000,54.4303797468354,0.51965811965812,353,323,30
"44",2000,60.2389078498293,0.552028218694885,429,326,103
"45",2000,55.7788944723618,0.515151515151515,367,327,40
"46",2000,55,0.608303249097473,355,354,1
"47",2000,59.4594594594595,0.548780487804878,540,471,69
"48",2000,49.053356282272,0.542649727767695,269,440,-171
"49",2000,56.2753036437247,0.560897435897436,479,299,180
"50",2000,53.6992840095465,0.495274102079395,323,226,97
"51",2000,58.0952380952381,0.601317957166392,397,371,26
"52",2000,53.3661740558292,0.55731922398589,276,338,-62
"53",2000,54.9905838041431,0.513661202185792,354,305,49
"54",2000,56.0798548094374,0.517515923566879,328,246,82
"55",2000,53.858024691358,0.476449275362319,321,321,0
"56",2000,53.2467532467533,0.522689075630252,351,245,106
"57",2000,45.0733752620545,0.501805054151625,321,255,66
"58",2000,55.4744525547445,0.596078431372549,320,405,-85
"59",2000,60.3015075376884,0.533219761499148,388,422,-34
"60",2000,50,0.519440124416796,388,269,119
"61",2000,58.2463465553236,0.46615087040619,346,191,155
"62",2000,58.2905982905983,0.498,281,269,12
"63",2001,54.7747747747748,0.588132635253054,295,343,-48
"64",2001,50.5454545454545,0.59963768115942,291,377,-86
"65",2001,53.3333333333333,0.535,303,265,38
"66",2001,53.6945812807882,0.583162217659138,265,420,-155
"67",2001,51.0569105691057,0.566666666666667,253,410,-157
"68",2001,58.0110497237569,0.546153846153846,338,203,135
"69",2001,51.0301109350238,0.552397868561279,226,309,-83
"70",2001,53.9651837524178,0.517587939698492,285,319,-34
"71",2001,46.9798657718121,0.556201550387597,246,338,-92
"72",2001,56.1151079136691,0.555956678700361,340,339,1
"73",2001,50.367107195301,0.571428571428572,270,424,-154
"74",2001,58.8014981273408,0.5328125,390,266,124
"75",2001,59.4548551959114,0.563405797101449,413,486,-73
"76",2001,53.6789297658863,0.601018675721562,294,286,8
"77",2001,52.8169014084507,0.565965583173996,320,344,-24
"78",2001,63.8047138047138,0.534013605442177,503,273,230
"79",2001,53.6458333333333,0.548442906574394,332,321,11
"80",2001,62.7586206896552,0.506993006993007,399,327,72
"81",2001,57.2916666666667,0.51984126984127,344,290,54
"82",2001,55.4635761589404,0.570588235294118,290,390,-100
"83",2001,57.8449905482042,0.506779661016949,371,272,99
"84",2001,50.9771986970684,0.547244094488189,333,409,-76
"85",2001,54.1390728476821,0.523725834797891,294,321,-27
"86",2001,56.0824742268041,0.569090909090909,308,295,13
"87",2001,53.3807829181495,0.51063829787234,343,208,135
"88",2001,56.3786008230453,0.507745266781411,352,212,140
"89",2001,50.390625,0.564059900166389,301,324,-23
"90",2001,59.5505617977528,0.550580431177446,409,282,127
"91",2001,56.386292834891,0.508379888268157,324,280,44
"92",2001,54.6263345195729,0.554054054054054,336,388,-52
"93",2001,49.7881355932203,0.526104417670683,256,303,-47
"94",2002,49.3220338983051,0.604693140794224,262,417,-155
"95",2002,52.0388349514563,0.506216696269982,402,314,88
"96",2002,50.2879078694818,0.593080724876442,316,354,-38
"97",2002,56.5217391304348,0.533206831119545,379,397,-18
"98",2002,50.1968503937008,0.510452961672474,258,302,-44
"99",2002,52.6315789473684,0.574614065180103,281,379,-98
"100",2002,55.7324840764331,0.599164926931106,279,456,-177
"101",2002,57.4829931972789,0.551660516605166,344,320,24
"102",2002,48.0916030534351,0.560402684563758,217,329,-112
"103",2002,59.7337770382695,0.59016393442623,392,344,48
"104",2002,46.2437395659432,0.5936,306,451,-145
"105",2002,59.4728171334432,0.498263888888889,398,328,70
"106",2002,44.7619047619048,0.512773722627737,213,356,-143
"107",2002,63.5332252836305,0.572564612326044,349,313,36
"108",2002,53.2803180914513,0.563734290843806,328,315,13
"109",2002,57.936507936508,0.62,467,399,68
"110",2002,59.9118942731278,0.584,316,369,-53
"111",2002,57.3451327433628,0.580495356037152,333,367,-34
"112",2002,63.6225266362253,0.560777957860616,450,304,146
"113",2002,56.4583333333333,0.514886164623468,378,301,77
"114",2002,55.5189456342669,0.584642233856894,390,442,-52
"115",2002,58.4375,0.55575221238938,381,346,35
"116",2002,50.259067357513,0.540157480314961,432,388,44
"117",2002,58.8850174216028,0.534364261168385,320,279,41
"118",2002,63.3911368015414,0.615780445969125,359,336,23
"119",2002,54.2662116040956,0.537096774193548,415,241,174
"120",2002,59.3220338983051,0.536741214057508,390,345,45
"121",2002,58.2258064516129,0.549657534246575,355,369,-14
"122",2002,59.7972972972973,0.582191780821918,367,351,16
"123",2002,56.9558101472995,0.469202898550725,346,196,150
"124",2002,58.5086042065009,0.559405940594059,367,324,43
"125",2002,50.0834724540902,0.532399299474606,307,365,-58
"126",2003,52.5129982668978,0.6003861003861,225,452,-227
"127",2003,46.4646464646465,0.590493601462523,299,422,-123
"128",2003,47.6923076923077,0.512998266897747,391,281,110
"129",2003,52.8880866425993,0.521978021978022,243,279,-36
"130",2003,55.327868852459,0.532976827094474,325,304,21
"131",2003,49.0942028985507,0.60036832412523,283,346,-63
"132",2003,58.3783783783784,0.551020408163265,346,384,-38
"133",2003,56.8058076225045,0.556179775280899,254,322,-68
"134",2003,53.9449541284404,0.45697896749522,289,260,29
"135",2003,56,0.49718574108818,381,301,80
"136",2003,53.4338358458961,0.605118829981719,270,379,-109
"137",2003,62.753036437247,0.526655896607431,442,307,135
"138",2003,52.5423728813559,0.568965517241379,255,380,-125
"139",2003,64.685908319185,0.583157894736842,447,336,111
"140",2003,55.8011049723757,0.567415730337079,276,331,-55
"141",2003,60.5357142857143,0.56175972927242,484,332,152
"142",2003,58.7227414330218,0.536231884057971,447,328,119
"143",2003,54.0983606557377,0.587591240875912,313,441,-128
"144",2003,49.7316636851521,0.582484725050917,270,379,-109
"145",2003,53.4303534303534,0.558669001751313,311,261,50
"146",2003,59.4642857142857,0.544658493870403,416,353,63
"147",2003,56.3380281690141,0.49923896499239,348,238,110
"148",2003,55.1845342706503,0.511627906976744,340,326,14
"149",2003,52.3592085235921,0.548845470692718,243,387,-144
"150",2003,59.0909090909091,0.573469387755102,283,299,-16
"151",2003,53.1428571428571,0.563545150501672,374,287,87
"152",2003,53.5901926444834,0.571984435797666,300,327,-27
"153",2003,56.3055062166963,0.560457516339869,404,327,77
"154",2003,55.6797020484171,0.557553956834532,384,337,47
"155",2003,60,0.539370078740158,301,264,37
"156",2003,60,0.569468267581475,435,324,111
"157",2003,49.3891797556719,0.558823529411765,287,372,-85
"158",2004,52.0905923344948,0.496336996336996,284,322,-38
"159",2004,48.8738738738739,0.578483245149912,340,337,3
"160",2004,52.4390243902439,0.513011152416357,317,268,49
"161",2004,53.5787321063395,0.490601503759398,395,284,111
"162",2004,54.4658493870403,0.552919708029197,355,339,16
"163",2004,46.3687150837989,0.522768670309654,231,331,-100
"164",2004,57.6512455516015,0.567028985507247,374,372,2
"165",2004,52.1829521829522,0.563008130081301,276,390,-114
"166",2004,55.8983666061706,0.577281191806331,293,405,-112
"167",2004,56.8480300187617,0.519083969465649,381,304,77
"168",2004,52.7777777777778,0.570434782608696,296,350,-54
"169",2004,62.6229508196721,0.562724014336918,424,380,44
"170",2004,55.2123552123552,0.620938628158845,309,339,-30
"171",2004,65.4916512059369,0.607679465776294,522,351,171
"172",2004,55.5555555555556,0.575187969924812,261,280,-19
"173",2004,62.3946037099494,0.553191489361702,483,435,48
"174",2004,59.2356687898089,0.553030303030303,319,392,-73
"175",2004,61.407249466951,0.586750788643533,446,313,133
"176",2004,53.7459283387622,0.589887640449438,320,442,-122
"177",2004,48.1308411214953,0.520255863539446,275,354,-79
"178",2004,63.5451505016722,0.582758620689655,405,395,10
"179",2004,57.5638506876228,0.537542662116041,437,260,177
"180",2004,52.8205128205128,0.558620689655173,348,405,-57
"181",2004,51.3358778625954,0.574803149606299,303,347,-44
"182",2004,59.7457627118644,0.546313799621928,333,261,72
"183",2004,57.4358974358975,0.561344537815126,386,260,126
"184",2004,57.8680203045685,0.516314779270634,372,251,121
"185",2004,53.7102473498233,0.577249575551783,371,373,-2
"186",2004,52.6742301458671,0.592307692307692,259,452,-193
"187",2004,61.0412926391382,0.513513513513514,301,304,-3
"188",2004,56.5079365079365,0.602169981916817,344,439,-95
"189",2004,52.0795660036166,0.532608695652174,240,265,-25
"190",2005,58.6834733893558,0.573055028462998,311,387,-76
"191",2005,50,0.570409982174688,351,341,10
"192",2005,55.8333333333333,0.525754884547069,265,299,-34
"193",2005,54.3259557344064,0.58364312267658,271,367,-96
"194",2005,56.3941299790356,0.530434782608696,391,259,132
"195",2005,48.7750556792873,0.531409168081494,260,202,58
"196",2005,64.5276292335116,0.595588235294118,421,350,71
"197",2005,54.8983364140481,0.567073170731708,232,301,-69
"198",2005,54.8446069469835,0.511320754716981,325,308,17
"199",2005,57.0552147239264,0.536661466458658,395,258,137
"200",2005,54,0.570599613152805,254,345,-91
"201",2005,58.4732824427481,0.540772532188841,298,344,-46
"202",2005,52.3255813953488,0.601980198019802,260,431,-171
"203",2005,64.804469273743,0.620253164556962,439,247,192
"204",2005,54.5279383429672,0.539772727272727,361,269,92
"205",2005,58.9219330855019,0.550847457627119,403,325,78
"206",2005,60.6811145510836,0.574040219378428,363,429,-66
"207",2005,61.121157323689,0.553191489361702,418,312,106
"208",2005,49.607535321821,0.567049808429119,290,383,-93
"209",2005,50.4332755632582,0.541946308724832,318,317,1
"210",2005,57.2953736654804,0.563604240282685,306,344,-38
"211",2005,59.3591905564924,0.526690391459075,379,338,41
"212",2005,52.2033898305085,0.542792792792793,235,398,-163
"213",2005,50.0851788756388,0.53160453808752,422,314,108
"214",2005,51.0476190476191,0.578411405295316,240,355,-115
"215",2005,50.9833585476551,0.559322033898305,310,388,-78
"216",2005,55.609756097561,0.529411764705882,389,258,131
"217",2005,61.2774451097804,0.533011272141707,452,271,181
"218",2005,46.6819221967963,0.616144975288303,239,428,-189
"219",2005,57.9349904397706,0.542239685658153,300,274,26
"220",2005,57.8352180936995,0.578125,299,421,-122
"221",2005,54.1910331384016,0.512323943661972,359,293,66
"222",2006,56.1188811188811,0.576301615798923,314,389,-75
"223",2006,47.9569892473118,0.58287795992714,292,328,-36
"224",2006,61.1940298507463,0.489473684210526,353,201,152
"225",2006,56.3941299790356,0.59016393442623,300,311,-11
"226",2006,56.9176882661996,0.537892791127542,270,305,-35
"227",2006,52.513966480447,0.538336052202284,427,255,172
"228",2006,58.8129496402878,0.597269624573379,373,331,42
"229",2006,56.50623885918,0.533834586466166,238,356,-118
"230",2006,56.8807339449541,0.554327808471455,425,350,75
"231",2006,52.8925619834711,0.570680628272251,319,305,14
"232",2006,56.5349544072948,0.627777777777777,305,398,-93
"233",2006,53.680981595092,0.511627906976744,301,366,-65
"234",2006,62.906309751434,0.621212121212121,267,366,-99
"235",2006,63.5087719298246,0.608200455580866,427,360,67
"236",2006,55.8577405857741,0.526881720430107,371,274,97
"237",2006,55.2845528455285,0.591337099811676,331,315,16
"238",2006,58.4251968503937,0.553014553014553,367,381,-14
"239",2006,57.9797979797979,0.516891891891892,492,303,189
"240",2006,47.6449275362319,0.555555555555556,168,332,-164
"241",2006,54.5454545454546,0.512867647058824,260,283,-23
"242",2006,57.2413793103448,0.566188197767145,282,327,-45
"243",2006,58.6021505376344,0.525,385,237,148
"244",2006,61.7549668874172,0.523529411764706,413,322,91
"245",2006,55.1282051282051,0.55685618729097,355,362,-7
"246",2006,60.7766990291262,0.558098591549296,316,295,21
"247",2006,56.5674255691769,0.550802139037433,398,328,70
"248",2006,55.026455026455,0.567615658362989,353,315,38
"249",2006,52.3297491039427,0.546617915904936,335,341,-6
"250",2006,54.1841004184101,0.59963768115942,298,412,-114
"251",2006,52.3893805309734,0.583333333333333,211,353,-142
"252",2006,47.7801268498943,0.600358422939068,324,400,-76
"253",2006,55.8044806517312,0.571992110453649,307,376,-69
"254",2007,58.3333333333333,0.595709570957096,404,399,5
"255",2007,55.8139534883721,0.608303249097473,259,414,-155
"256",2007,57.6988155668359,0.561302681992337,275,384,-109
"257",2007,56.1965811965812,0.602040816326531,252,354,-102
"258",2007,52.9739776951673,0.601785714285714,267,347,-80
"259",2007,53.9735099337748,0.592400690846287,334,348,-14
"260",2007,63.2203389830509,0.632616487455197,380,385,-5
"261",2007,54.561717352415,0.562913907284768,402,382,20
"262",2007,61.4003590664273,0.551612903225806,455,325,130
"263",2007,59.9264705882353,0.569387755102041,320,409,-89
"264",2007,57.5899843505477,0.663522012578617,346,444,-98
"265",2007,64.5868465430017,0.516695957820738,435,291,144
"266",2007,63.254113345521,0.626736111111111,379,384,-5
"267",2007,61.8466898954704,0.616698292220114,450,262,188
"268",2007,57.8313253012048,0.550774526678141,411,304,107
"269",2007,54.2071197411003,0.557575757575758,226,335,-109
"270",2007,53.6231884057971,0.579234972677595,263,438,-175
"271",2007,56.6532258064516,0.567114093959732,412,284,128
"272",2007,52.6315789473684,0.563714902807775,283,398,-115
"273",2007,53.7162162162162,0.558891454965358,267,437,-170
"274",2007,54.1304347826087,0.607613469985359,365,311,54
"275",2007,66.3920922570017,0.551845342706503,589,274,315
"276",2007,66.0660660660661,0.591320072332731,379,388,-9
"277",2007,52.9824561403509,0.534965034965035,373,351,22
"278",2007,55.2584670231729,0.579158316633266,268,355,-87
"279",2007,55.9105431309904,0.544502617801047,336,300,36
"280",2007,57.8732106339468,0.514084507042253,393,269,124
"281",2007,59.4551282051282,0.541463414634146,393,291,102
"282",2007,48.7544483985765,0.602094240837696,219,364,-145
"283",2007,60.536398467433,0.568965517241379,334,270,64
"284",2007,58.4178498985801,0.573070607553366,301,297,4
"285",2007,57.5812274368231,0.558028616852146,334,310,24
"286",2008,63.4848484848485,0.588342440801457,427,426,1
"287",2008,58.8888888888889,0.561312607944732,391,325,66
"288",2008,55.8886509635974,0.493761140819964,385,244,141
"289",2008,60.233918128655,0.584139264990329,336,342,-6
"290",2008,56.8129330254041,0.560606060606061,414,329,85
"291",2008,54.8387096774193,0.591962905718702,375,350,25
"292",2008,53.9964476021314,0.6,204,364,-160
"293",2008,46.2135922330097,0.61822125813449,232,350,-118
"294",2008,56.6493955094992,0.544973544973545,362,365,-3
"295",2008,61.3672496025437,0.640384615384615,370,448,-78
"296",2008,50.2683363148479,0.638655462184874,268,517,-249
"297",2008,59.965034965035,0.527573529411765,419,380,39
"298",2008,63.1669535283993,0.591182364729459,366,394,-28
"299",2008,65.7190635451505,0.648330058939096,377,298,79
"300",2008,57.9584775086505,0.602434077079108,302,367,-65
"301",2008,53.7261698440208,0.651685393258427,291,440,-149
"302",2008,51.6754850088183,0.588235294117647,232,465,-233
"303",2008,61.4173228346457,0.648264984227129,439,347,92
"304",2008,48.3660130718954,0.537373737373737,263,388,-125
"305",2008,64.2023346303502,0.542372881355932,345,317,28
"306",2008,54.158215010142,0.565445026178011,379,333,46
"307",2008,58.6206896551724,0.57029702970297,410,309,101
"308",2008,64.1304347826087,0.537769784172662,463,393,70
"309",2008,57.3076923076923,0.547134935304991,427,294,133
"310",2008,61.9642857142857,0.607260726072607,405,356,49
"311",2008,57.92,0.497373029772329,416,289,127
"312",2008,54.9728752260398,0.516295025728988,347,223,124
"313",2008,51.3725490196078,0.61,294,392,-98
"314",2008,55.0802139037433,0.574652777777778,339,381,-42
"315",2008,59.9662162162162,0.547619047619048,361,323,38
"316",2008,56.9593147751606,0.556818181818182,375,234,141
"317",2008,58.1352833638026,0.546139359698682,265,296,-31
"318",2009,64.0065146579805,0.544025157232704,375,325,50
"319",2009,56.175972927242,0.595744680851064,363,325,38
"320",2009,58.8990825688073,0.552346570397112,391,261,130
"321",2009,52.5667351129364,0.533453887884268,258,326,-68
"322",2009,53.3333333333333,0.58206106870229,315,308,7
"323",2009,57.2390572390572,0.604609929078014,327,375,-48
"324",2009,56.6336633663366,0.552083333333333,305,291,14
"325",2009,46.3983050847458,0.559928443649374,245,375,-130
"326",2009,59.6219931271478,0.561174551386623,361,250,111
"327",2009,57.6013513513513,0.543795620437956,326,324,2
"328",2009,50.8038585209003,0.652631578947368,262,494,-232
"329",2009,59.0082644628099,0.509532062391681,461,297,164
"330",2009,64.7727272727273,0.598260869565217,388,333,55
"331",2009,65.3658536585366,0.60586319218241,416,307,109
"332",2009,56.25,0.654648956356736,290,380,-90
"333",2009,51.2953367875648,0.569811320754717,294,424,-130
"334",2009,53.1623931623932,0.611650485436893,175,436,-261
"335",2009,62.2467771639042,0.575971731448763,454,320,134
"336",2009,48.1132075471698,0.548728813559322,197,379,-182
"337",2009,57.4652777777778,0.527204502814259,360,390,-30
"338",2009,64.6153846153846,0.583904109589041,470,312,158
"339",2009,63.6215334420881,0.553505535055351,427,285,142
"340",2009,66.9026548672566,0.544554455445545,510,341,169
"341",2009,59.0909090909091,0.590225563909775,402,427,-25
"342",2009,49.5283018867924,0.48501872659176,348,236,112
"343",2009,56.4924114671164,0.567307692307692,429,337,92
"344",2009,60,0.536013400335008,368,324,44
"345",2009,57.0552147239264,0.630691399662732,280,390,-110
"346",2009,55.026455026455,0.571428571428572,330,281,49
"347",2009,50.2692998204668,0.596039603960396,244,400,-156
"348",2009,55.3061224489796,0.635646687697161,354,402,-48
"349",2009,59.0277777777778,0.572727272727273,266,336,-70
"350",2010,46.6448445171849,0.573451327433628,289,434,-145
"351",2010,59.9667774086379,0.614864864864865,414,288,126
"352",2010,58.0037664783428,0.561093247588425,357,270,87
"353",2010,53.5262206148282,0.590361445783132,283,425,-142
"354",2010,48.1203007518797,0.588447653429603,196,408,-212
"355",2010,52.6717557251908,0.592169657422512,334,286,48
"356",2010,58.9660743134087,0.603703703703704,322,395,-73
"357",2010,57.6998050682261,0.577570093457944,271,332,-61
"358",2010,62.4382207578253,0.607329842931937,394,436,-42
"359",2010,54.0453074433657,0.564638783269962,344,471,-127
"360",2010,58.030303030303,0.585106382978723,362,369,-7
"361",2010,61.0051993067591,0.516579406631762,388,240,148
"362",2010,60.530679933665,0.614583333333333,390,427,-37
"363",2010,64.7482014388489,0.63458110516934,435,388,47
"364",2010,57.5098814229249,0.620754716981132,353,419,-66
"365",2010,54.3650793650794,0.517017828200973,366,326,40
"366",2010,57.0048309178744,0.535947712418301,289,328,-39
"367",2010,61.6838487972509,0.533707865168539,441,322,119
"368",2010,52.3452157598499,0.483495145631068,410,371,39
"369",2010,56.5656565656566,0.534322820037106,273,333,-60
"370",2010,56.1694290976059,0.597845601436266,281,348,-67
"371",2010,62.1013133208255,0.599383667180278,518,313,205
"372",2010,65.7894736842105,0.577358490566038,384,307,77
"373",2010,61.1913357400722,0.525597269624573,394,347,47
"374",2010,52.4590163934426,0.472759226713533,367,304,63
"375",2010,57.4257425742574,0.538327526132404,439,377,62
"376",2010,58.0896686159844,0.565420560747663,375,232,143
"377",2010,55.8620689655172,0.545893719806763,310,407,-97
"378",2010,52.1256931608133,0.614065180102916,305,346,-41
"379",2010,58.2857142857143,0.563302752293578,341,318,23
"380",2010,54.4910179640719,0.619335347432024,356,339,17
"381",2010,53.5276073619632,0.602627257799672,302,377,-75
"382",2011,50.9121061359867,0.549273021001615,312,348,-36
"383",2011,59.4462540716612,0.574324324324324,402,350,52
"384",2011,54.419410745234,0.495697074010327,378,266,112
"385",2011,59.5317725752508,0.601123595505618,372,434,-62
"386",2011,56.3176895306859,0.609195402298851,406,429,-23
"387",2011,51.6377649325626,0.579425113464448,353,341,12
"388",2011,54.9019607843137,0.548109965635739,344,323,21
"389",2011,52.7182866556837,0.531062124248497,218,307,-89
"390",2011,62.1487603305785,0.573378839590444,369,347,22
"391",2011,46.3675213675214,0.581151832460733,309,390,-81
"392",2011,60,0.5875,474,387,87
"393",2011,63.5135135135135,0.584707646176912,560,359,201
"394",2011,58.2995951417004,0.479381443298969,381,278,103
"395",2011,53.4513274336283,0.673704414587332,243,430,-187
"396",2011,46.875,0.601476014760148,243,329,-86
"397",2011,56.3088512241055,0.532091097308489,212,338,-126
"398",2011,48.3443708609271,0.561302681992337,193,407,-214
"399",2011,60,0.588582677165354,406,377,29
"400",2011,57.4817518248175,0.511041009463722,359,433,-74
"401",2011,53.639846743295,0.555555555555556,329,313,16
"402",2011,51.1627906976744,0.626279863481229,340,449,-109
"403",2011,62.5194401244168,0.585735963581183,513,342,171
"404",2011,69.0058479532164,0.551829268292683,547,339,208
"405",2011,58.1847649918963,0.567610062893082,394,400,-6
"406",2011,52.991452991453,0.510204081632653,377,363,14
"407",2011,56.7986230636833,0.528998242530756,396,328,68
"408",2011,58.8946459412781,0.513321492007105,325,227,98
"409",2011,53.584229390681,0.564459930313589,321,315,6
"410",2011,55.8467741935484,0.535369774919614,380,229,151
"411",2011,58.8709677419355,0.599601593625498,287,494,-207
"412",2011,58.2508250825083,0.6,325,317,8
"413",2011,54.746835443038,0.56,288,367,-79
"414",2012,50.6766917293233,0.504672897196262,250,357,-107
"415",2012,65.527950310559,0.580034423407917,419,299,120
"416",2012,55.7595993322204,0.564924114671164,398,344,54
"417",2012,57.2222222222222,0.537785588752197,344,435,-91
"418",2012,54.1984732824427,0.6214405360134,357,363,-6
"419",2012,54.1509433962264,0.552922590837283,375,277,98
"420",2012,57.4614065180103,0.568144499178982,391,320,71
"421",2012,54.5757071547421,0.597156398104265,302,368,-66
"422",2012,62.536023054755,0.588235294117647,376,400,-24
"423",2012,66.2273476112026,0.525368248772504,481,289,192
"424",2012,58.1699346405229,0.599653379549393,372,437,-65
"425",2012,61.4121510673235,0.508943089430894,433,336,97
"426",2012,60.8247422680412,0.49438202247191,416,331,85
"427",2012,51.2084592145015,0.589065255731922,357,387,-30
"428",2012,51.41065830721,0.616636528028933,255,444,-189
"429",2012,53.6345776031434,0.569387755102041,211,425,-214
"430",2012,56.271186440678,0.605351170568562,299,348,-49
"431",2012,58.7826086956522,0.574503311258278,350,350,0
"432",2012,57.4045801526717,0.632058287795993,290,443,-153
"433",2012,54.1589648798521,0.548136645962733,288,317,-29
"434",2012,58.0270793036751,0.596946564885496,379,348,31
"435",2012,60.3603603603603,0.588516746411483,557,331,226
"436",2012,60.9510086455331,0.589171974522293,461,454,7
"437",2012,57.7817531305903,0.603539823008849,429,344,85
"438",2012,50.4638218923933,0.508604206500956,281,375,-94
"439",2012,55.187969924812,0.568093385214008,280,444,-164
"440",2012,58.3196046128501,0.533928571428571,336,314,22
"441",2012,59.1324200913242,0.546822742474916,412,245,167
"442",2012,60.5870020964361,0.559800664451827,397,273,124
"443",2012,52.3569023569024,0.629800307219662,389,394,-5
"444",2012,54.8275862068965,0.619205298013245,330,471,-141
"445",2012,61.5221987315011,0.586567164179104,436,388,48
"446",2013,58.8330632090762,0.548579970104634,379,324,55
"447",2013,63.2478632478633,0.622262773722628,353,443,-90
"448",2013,54.3413173652695,0.529510961214165,320,352,-32
"449",2013,52.3642732049037,0.50080775444265,339,388,-49
"450",2013,56.9200779727095,0.600961538461539,366,241,125
"451",2013,61.247947454844,0.583333333333333,445,478,-33
"452",2013,59.0909090909091,0.553516819571865,430,305,125
"453",2013,51.9890260631001,0.562790697674419,308,406,-98
"454",2013,60.1926163723916,0.614329268292683,439,432,7
"455",2013,66.3309352517986,0.545038167938931,606,399,207
"456",2013,56.2974203338391,0.554098360655738,395,376,19
"457",2013,59.4155844155844,0.568493150684932,417,428,-11
"458",2013,55.2083333333333,0.554054054054054,276,428,-152
"459",2013,56.4516129032258,0.5625,391,336,55
"460",2013,54.2768273716952,0.610344827586207,247,449,-202
"461",2013,57.1183533447684,0.523510971786834,430,305,125
"462",2013,55.4327808471455,0.617391304347826,348,364,-16
"463",2013,65.9685863874345,0.625429553264605,396,348,48
"464",2013,53.0249110320285,0.639316239316239,322,453,-131
"465",2013,55.0077041602465,0.555735056542811,317,335,-18
"466",2013,54.9915397631134,0.610787172011662,391,480,-89
"467",2013,57.0570570570571,0.528301886792453,444,338,106
"468",2013,64.919941775837,0.548736462093863,414,304,110
"469",2013,53.5420098846788,0.568503937007874,294,383,-89
"470",2013,50.5703422053232,0.5504,290,387,-97
"471",2013,55.4561717352415,0.574647887323944,442,382,60
"472",2013,60.4166666666667,0.544701986754967,379,370,9
"473",2013,57.6673866090713,0.54020979020979,417,231,186
"474",2013,53.5087719298245,0.554662379421222,406,272,134
"475",2013,51.8716577540107,0.604810996563574,288,389,-101
"476",2013,57.9505300353357,0.59515570934256,362,381,-19
"477",2013,54.1984732824427,0.612727272727273,334,478,-144
"478",2014,53.5117056856187,0.595432300163132,310,299,11
"479",2014,63.4294385432474,0.615780445969125,381,417,-36
"480",2014,60.5633802816901,0.592248062015504,409,302,107
"481",2014,58.9285714285714,0.550653594771242,343,289,54
"482",2014,55.80204778157,0.609715242881072,339,374,-35
"483",2014,60.5504587155963,0.62350936967632,319,442,-123
"484",2014,61.2903225806452,0.583067092651757,365,344,21
"485",2014,51.4071294559099,0.548281505728314,299,337,-38
"486",2014,64.950495049505,0.632027257240204,467,352,115
"487",2014,63.9423076923077,0.583333333333333,482,354,128
"488",2014,56.3271604938272,0.606973058637084,321,282,39
"489",2014,61.5520282186949,0.550413223140496,486,348,138
"490",2014,58.0708661417323,0.552511415525115,372,307,65
"491",2014,59.2485549132948,0.549828178694158,458,369,89
"492",2014,51.5055467511886,0.607876712328767,249,412,-163
"493",2014,58.8235294117647,0.538071065989848,353,281,72
"494",2014,58.2887700534759,0.635578583765112,324,354,-30
"495",2014,62.2950819672131,0.581818181818182,348,348,0
"496",2014,56.0675883256528,0.611408199643494,253,452,-199
"497",2014,61.5625,0.586805555555556,388,373,15
"498",2014,57.0921985815602,0.616055846422338,325,343,-18
"499",2014,61.6352201257861,0.554294975688817,468,313,155
"500",2014,66.6666666666667,0.588946459412781,401,424,-23
"501",2014,60.2201257861635,0.569420035149385,380,400,-20
"502",2014,52.5641025641026,0.595854922279793,283,401,-118
"503",2014,58.8957055214724,0.5390625,474,400,74
"504",2014,64.3192488262911,0.608695652173913,436,368,68
"505",2014,57.8629032258065,0.576427255985267,394,254,140
"506",2014,54.1743970315399,0.554794520547945,306,340,-34
"507",2014,52.076124567474,0.648241206030151,277,410,-133
"508",2014,53.3928571428571,0.594178082191781,254,438,-184
"509",2014,60.1652892561984,0.620503597122302,301,438,-137
"510",2015,60.5488850771869,0.560457516339869,489,313,176
"511",2015,62.5954198473283,0.636833046471601,339,345,-6
"512",2015,61.1190817790531,0.598290598290598,328,401,-73
"513",2015,58.0708661417323,0.554313099041533,379,359,20
"514",2015,56.390977443609,0.564399421128799,500,308,192
"515",2015,59.7495527728086,0.58974358974359,335,397,-62
"516",2015,62.1973929236499,0.604956268221574,419,279,140
"517",2015,55.7894736842106,0.595194085027726,278,432,-154
"518",2015,59.6428571428571,0.613382899628253,275,374,-99
"519",2015,57.1428571428572,0.549520766773163,355,296,59
"520",2015,62.0384047267356,0.629370629370629,358,400,-42
"521",2015,55.8587479935794,0.541315345699831,368,323,45
"522",2015,54.5731707317073,0.544240400667779,339,313,26
"523",2015,54.1158536585366,0.571890145395799,333,408,-75
"524",2015,53.7878787878788,0.613207547169812,376,448,-72
"525",2015,59.2734225621415,0.532012195121951,405,287,118
"526",2015,55.7142857142857,0.627358490566038,280,330,-50
"527",2015,62.3413258110014,0.605166051660517,320,398,-78
"528",2015,58.28125,0.590643274853801,359,399,-40
"529",2015,57.6619273301738,0.610820244328098,310,389,-79
"530",2015,58.9178356713427,0.594370860927152,365,302,63
"531",2015,60.7518796992481,0.557959814528594,465,315,150
"532",2015,65.8082975679542,0.643598615916955,408,476,-68
"533",2015,60.4006163328197,0.640909090909091,420,442,-22
"534",2015,57.8274760383387,0.5359375,387,314,73
"535",2015,61.4567526555387,0.588938714499253,377,430,-53
"536",2015,61.9651347068146,0.597325408618128,423,319,104
"537",2015,62.1268656716418,0.567291311754685,423,277,146
"538",2015,55.421686746988,0.647668393782384,238,387,-149
"539",2015,55.417406749556,0.653979238754325,342,417,-75
"540",2015,56.6225165562914,0.588560885608856,299,423,-124
"541",2015,65.982905982906,0.585123966942149,388,379,9
"542",2016,55.6686046511628,0.577181208053691,418,362,56
"543",2016,64.7058823529412,0.610709117221418,540,406,134
"544",2016,61.9181946403385,0.607907742998353,343,321,22
"545",2016,55,0.55535390199637,399,378,21
"546",2016,50.9151414309484,0.616892911010558,369,402,-33
"547",2016,59.3162393162393,0.604240282685512,279,399,-120
"548",2016,60.4651162790698,0.5984,325,315,10
"549",2016,53.2283464566929,0.610915492957747,264,452,-188
"550",2016,63.600782778865,0.632440476190476,421,306,115
"551",2016,55.5737704918033,0.515151515151515,333,297,36
"552",2016,61.5873015873016,0.691507798960139,346,358,-12
"553",2016,61.5267175572519,0.604575163398693,432,388,44
"554",2016,56.6993464052288,0.575812274368231,279,328,-49
"555",2016,59.0111642743222,0.613636363636364,411,392,19
"556",2016,55.8245083207262,0.597920277296361,318,400,-82
"557",2016,63.0397236614853,0.558213716108453,389,311,78
"558",2016,53.4246575342465,0.616639477977162,224,394,-170
"559",2016,56.5640194489465,0.590909090909091,410,423,-13
"560",2016,61.3268608414239,0.577464788732394,416,385,31
"561",2016,62.4505928853755,0.587859424920128,363,380,-17
"562",2016,66.0287081339713,0.565587734241908,327,307,20
"563",2016,64.1114982578397,0.583201267828843,441,250,191
"564",2016,67.816091954023,0.61764705882353,469,454,15
"565",2016,60.8064516129032,0.558245083207262,310,284,26
"566",2016,53.1623931623932,0.606643356643357,275,409,-134
"567",2016,59.0979782270607,0.567291311754685,367,331,36
"568",2016,61.2540192926045,0.603803486529318,399,327,72
"569",2016,60.4269293924466,0.570689655172414,354,292,62
"570",2016,53.4450651769087,0.584392014519056,309,480,-171
"571",2016,57.3505654281099,0.589134125636672,354,369,-15
"572",2016,57.7067669172932,0.574814814814815,381,378,3
"573",2016,64.7058823529412,0.618210862619808,396,383,13
"574",2017,52.073732718894,0.568822553897181,295,361,-66
"575",2017,62.2504537205082,0.614601018675722,353,315,38
"576",2017,61.2141652613828,0.547697368421052,395,303,92
"577",2017,55.3639846743295,0.616666666666667,302,359,-57
"578",2017,54.6641791044776,0.587939698492462,363,327,36
"579",2017,56.8359375,0.59965034965035,264,320,-56
"580",2017,55.3734061930783,0.56,290,349,-59
"581",2017,50.0802568218299,0.644007155635063,234,410,-176
"582",2017,58.745247148289,0.619365609348915,354,332,22
"583",2017,53.5483870967742,0.561068702290076,289,382,-93
"584",2017,60.2254428341385,0.602965403624382,410,376,34
"585",2017,57.2357723577236,0.630434782608696,320,384,-64
"586",2017,51.7301038062284,0.601123595505618,338,436,-98
"587",2017,52.6802218114602,0.590405904059041,263,404,-141
"588",2017,56.936936936937,0.515151515151515,417,268,149
"589",2017,62.5862068965517,0.538971807628524,415,339,76
"590",2017,58.8235294117647,0.537313432835821,478,329,149
"591",2017,61,0.57719298245614,355,272,83
"592",2017,59.4178082191781,0.64349376114082,301,373,-72
"593",2017,58.7401574803149,0.60752688172043,281,393,-112
"594",2017,64.3243243243243,0.547297297297298,382,252,130
"595",2017,62.3397435897436,0.583465818759936,458,296,162
"596",2017,69.8010849909584,0.549248747913188,448,326,122
"597",2017,57.8294573643411,0.59114139693356,246,388,-142
"598",2017,58.3032490974729,0.55952380952381,298,382,-84
"599",2017,56.5505804311774,0.5671875,457,295,162
"600",2017,62.6427406199021,0.537070524412297,406,308,98
"601",2017,56.7612687813022,0.549915397631134,366,332,34
"602",2017,55.8641975308642,0.597222222222222,331,383,-52
"603",2017,58.5139318885449,0.650877192982456,335,382,-47
"604",2017,57.7358490566038,0.57032457496136,334,356,-22
"605",2017,59.7246127366609,0.534031413612565,342,388,-46
"606",2018,51.6423357664234,0.615107913669065,225,425,-200
"607",2018,64.4578313253012,0.6368,414,423,-9
"608",2018,56.8994889267462,0.541800643086817,389,287,102
"609",2018,49.9079189686925,0.589453860640301,269,374,-105
"610",2018,63.5294117647059,0.625886524822695,376,382,-6
"611",2018,62.6593806921676,0.563527653213752,421,283,138
"612",2018,57.0689655172414,0.630470016207455,368,455,-87
"613",2018,57.3051948051948,0.593655589123867,359,392,-33
"614",2018,61.0634648370497,0.633851468048359,339,324,15
"615",2018,59.0032154340836,0.596283783783784,329,349,-20
"616",2018,60.6796116504854,0.594843462246777,324,360,-36
"617",2018,56.5656565656566,0.587412587412588,376,400,-24
"618",2018,61.2788632326821,0.605345911949686,402,316,86
"619",2018,65.158371040724,0.667826086956522,433,344,89
"620",2018,55.668358714044,0.582089552238806,245,316,-71
"621",2018,63.2183908045977,0.586705202312139,565,421,144
"622",2018,61.1295681063123,0.603478260869565,527,384,143
"623",2018,62.9294755877034,0.598976109215017,428,329,99
"624",2018,63.4551495016612,0.604040404040404,290,467,-177
"625",2018,57.7075098814229,0.62037037037037,319,433,-114
"626",2018,65.5864197530864,0.567567567567567,360,341,19
"627",2018,63.6363636363636,0.584518167456556,436,325,111
"628",2018,70.4251386321627,0.615384615384616,504,353,151
"629",2018,60.2523659305994,0.616695059625213,369,412,-43
"630",2018,53.3928571428571,0.588141025641026,333,441,-108
"631",2018,66.2480376766091,0.620535714285714,367,348,19
"632",2018,64.1958041958042,0.583870967741935,428,360,68
"633",2018,59.447983014862,0.60374149659864,428,347,81
"634",2018,57.0689655172414,0.595155709342561,342,435,-93
"635",2018,60.9865470852018,0.677758318739054,396,464,-68
"636",2018,60.4123711340206,0.592267135325132,310,303,7
"637",2018,56.3405797101449,0.618803418803419,281,359,-78
"638",2019,58.8723051409619,0.65987460815047,361,442,-81
"639",2019,62.1109607577808,0.623445825932504,381,399,-18
"640",2019,61.8843683083512,0.543589743589744,531,282,249
"641",2019,54.2649727767695,0.580968280467446,314,259,55
"642",2019,55.2821997105644,0.580267558528428,340,470,-130
"643",2019,59.5505617977528,0.599337748344371,280,298,-18
"644",2019,54.0212443095599,0.584440227703985,279,420,-141
"645",2019,54.8275862068965,0.58029197080292,335,393,-58
"646",2019,62.4798711755234,0.60556464811784,434,321,113
"647",2019,57.2477064220183,0.604166666666667,282,316,-34
"648",2019,56.2091503267974,0.594383775351014,341,423,-82
"649",2019,58.3606557377049,0.557264957264957,376,313,63
"650",2019,60.9965635738832,0.609756097560976,378,385,-7
"651",2019,56.4338235294118,0.653399668325041,361,373,-12
"652",2019,57.0532915360502,0.578761061946903,300,397,-97
"653",2019,62.7906976744186,0.560509554140127,451,308,143
"654",2019,60.6106870229008,0.572368421052632,394,364,30
"655",2019,62.6391096979332,0.665314401622718,337,345,-8
"656",2019,66.6061705989111,0.603942652329749,313,419,-106
"657",2019,55.0445103857567,0.606701940035273,306,494,-188
"658",2019,64.1851106639839,0.604294478527607,407,303,104
"659",2019,58.1538461538462,0.520689655172414,420,225,195
"660",2019,69.4352159468438,0.567278287461774,458,341,117
"661",2019,57.4923547400611,0.624365482233503,341,451,-110
"662",2019,56.1739130434783,0.583601286173633,276,359,-83
"663",2019,60.0614439324117,0.565853658536585,385,354,31
"664",2019,57.9335793357933,0.551845342706502,289,303,-14
"665",2019,60.4609929078014,0.610845295055821,405,398,7
"666",2019,64.0232108317215,0.559859154929577,479,310,169
"667",2019,56.3421828908555,0.568245125348189,458,449,9
"668",2019,59.4,0.600311041990669,402,331,71
"669",2019,56.120527306968,0.633105802047782,266,435,-169
"670",2020,64.7157190635452,0.591572123176661,410,367,43
"671",2020,60.8047690014903,0.65284178187404,396,414,-18
"672",2020,58.9449541284404,0.598425196850394,468,303,165
"673",2020,65.7051282051282,0.601957585644372,501,375,126
"674",2020,63.6518771331058,0.65139116202946,350,402,-52
"675",2020,61.8461538461539,0.604490500863558,372,370,2
"676",2020,59.4249201277955,0.609318996415771,311,424,-113
"677",2020,60.2294455066922,0.595505617977528,408,419,-11
"678",2020,60.5571847507331,0.597449908925319,395,473,-78
"679",2020,53.6379018612521,0.612111292962357,323,446,-123
"680",2020,60.3225806451613,0.65582191780822,377,519,-142
"681",2020,68.3823529411765,0.600694444444444,509,369,140
"682",2020,64.0468227424749,0.651122625215889,384,464,-80
"683",2020,64.8601398601399,0.617056856187291,451,362,89
"684",2020,58.1954887218045,0.670289855072464,306,492,-186
"685",2020,64.0243902439024,0.592529711375212,473,362,111
"686",2020,63.843648208469,0.579298831385643,372,296,76
"687",2020,62.5757575757576,0.596491228070175,384,426,-42
"688",2020,64.1739130434783,0.613598673300166,434,478,-44
"689",2020,62.2895622895623,0.587328767123288,404,338,66
"690",2020,62.432915921288,0.635879218472469,430,475,-45
"691",2020,59.453781512605,0.642857142857143,326,353,-27
"692",2020,67.2727272727273,0.550413223140496,482,337,145
"693",2020,56.414762741652,0.627831715210356,280,357,-77
"694",2020,53.9741219963032,0.661392405063291,243,457,-214
"695",2020,50,0.630849220103986,334,418,-84
"696",2020,63.4074074074074,0.512027491408935,416,312,104
"697",2020,63.3986928104575,0.625,459,371,88
"698",2020,60.6209150326797,0.601410934744268,376,390,-14
"699",2020,63.4674922600619,0.638680659670165,492,355,137
"700",2020,61.598440545809,0.647779479326187,491,439,52
"701",2020,59.480122324159,0.571923743500867,335,329,6
"702",2021,65.5608214849921,0.608623548922057,449,366,83
"703",2021,61.4006514657981,0.652754590984975,313,459,-146
"704",2021,59.2814371257485,0.604261796042618,387,392,-5
"705",2021,60.4956268221574,0.516521739130435,483,289,194
"706",2021,53.2924961715161,0.605026929982046,304,404,-100
"707",2021,55.2412645590682,0.598095238095238,311,407,-96
"708",2021,62.9508196721311,0.62780269058296,460,376,84
"709",2021,56.2390158172232,0.58908507223114,349,371,-22
"710",2021,64.8175182481752,0.553191489361703,530,358,172
"711",2021,60.7204116638079,0.568333333333333,335,322,13
"712",2021,62.8571428571429,0.624347826086957,325,467,-142
"713",2021,64.32,0.587596899224806,450,371,79
"714",2021,60.2040816326531,0.626943005181347,280,452,-172
"715",2021,58.1687612208258,0.615141955835962,451,365,86
"716",2021,56.5830721003135,0.655652173913043,253,457,-204
"717",2021,63.6363636363636,0.625585023400936,480,364,116
"718",2021,63.3385335413416,0.619047619047619,460,372,88
"719",2021,62.2191011235955,0.6,474,459,15
"720",2021,64.2215568862275,0.623052959501558,374,439,-65
"721",2021,61.5853658536585,0.573846153846154,341,373,-32
"722",2021,62.9746835443038,0.591445427728614,425,426,-1
"723",2021,64.5390070921986,0.553819444444444,462,303,159
"724",2021,53.9594843462247,0.577464788732394,364,335,29
"725",2021,55.8028616852147,0.625194401244168,258,416,-158
"726",2021,54.0909090909091,0.646774193548387,310,504,-194
"727",2021,58.2542694497154,0.660743134087238,444,385,59
"728",2021,60.3693181818182,0.573505654281098,343,398,-55
"729",2021,59.7785977859779,0.639249639249639,395,366,29
"730",2021,62.8205128205128,0.625210084033614,427,365,62
"731",2021,65.3386454183267,0.611263736263736,511,353,158
"732",2021,61.6838487972509,0.585185185185185,419,354,65
"733",2021,59.9326599326599,0.626959247648903,335,434,-99
"734",2022,60.7293127629734,0.656101426307448,340,449,-109
"735",2022,57.1111111111111,0.639175257731959,365,386,-21
"736",2022,57.4712643678161,0.613707165109034,350,315,35
"737",2022,59.4728171334432,0.592471358428805,455,286,169
"738",2022,54.3788187372709,0.622764227642276,347,374,-27
"739",2022,50.7972665148064,0.643426294820717,326,463,-137
"740",2022,63.5258358662614,0.563356164383562,418,322,96
"741",2022,57.7586206896552,0.567567567567567,361,381,-20
"742",2022,60.8919382504288,0.572139303482587,467,342,125
"743",2022,54.416403785489,0.611544461778471,287,359,-72
"744",2022,62.5816993464052,0.584437086092715,453,427,26
"745",2022,61.1764705882353,0.612085769980507,370,371,-1
"746",2022,56.7741935483871,0.6,289,420,-131
"747",2022,59.6701649175412,0.620748299319728,289,427,-138
"748",2022,62.7388535031847,0.600624024960998,404,350,54
"749",2022,63.9705882352941,0.603550295857988,496,369,127
"750",2022,59.0136054421768,0.632377740303541,307,384,-77
"751",2022,64.6666666666667,0.56672760511883,391,384,7
"752",2022,57.5320512820513,0.643548387096774,395,418,-23
"753",2022,59.3548387096774,0.625563909774436,397,399,-2
"754",2022,62.2222222222222,0.621951219512195,424,427,-3
"755",2022,61.4065180102916,0.558282208588957,364,347,17
"756",2022,61.4545454545455,0.550427350427351,330,345,-15
"757",2022,60.8084358523726,0.57495881383855,365,371,-6
"758",2022,53.3632286995516,0.577371048252912,296,316,-20
"759",2022,60.3448275862069,0.56,477,344,133
"760",2022,59.672131147541,0.572413793103448,308,346,-38
"761",2022,64.3548387096774,0.578414839797639,407,401,6
"762",2022,62.2467771639042,0.608763693270736,450,277,173
"763",2022,64.3041237113402,0.592833876221498,313,358,-45
"764",2022,56.4356435643564,0.615708274894811,298,359,-61
"765",2022,56.67215815486,0.554954954954955,321,343,-22
